stream planing

story point - единица измерения сложности задачи
user story
бек лог продукта - список будущих задач
Бэклог спринта — краткосрочный план выполнения ряда заданий в рамках спринта.
incrent - функционал который несет пользователю пользу
Sprint Review – встреча в конце спринта (короткого интервала разработки продукта), на которой команда представляет заинтересованным лицам промежуточный результат работы, чтобы получить обратную связь.
stakeholders -
product owner - владелец самой компании
Scrum Master - человек (лидер слуга) который налаживает процесс
бизнес аналитик
Кроссплатформенность — способность программного обеспечения работать с несколькими аппаратными платформами или операционными системами.
Кросс-браузерность — свойство веб-сайта отображаться и функционировать во всех часто используемых браузерах идентично.
chief product officer - человек отвечающий за весь продукт
все что senior означает - квалифицированый специалист
inditify problem - понять проблему пользователя
market research - анализ рынка
value proposition - дать предложение пользователю
product scope - фнкция продукта
sprint -
Спринт — это короткий временной интервал, в течение которого scrum-команда выполняет заданный объем работы.
диаграмы ганта
цээрм системы
джира
менеджер общается с заказчиком

1. Product stradegy

Mission - миссия продукта, для чего он существует
Market - люди которые покупают наш продукт
native aplication - приложение только для одной системы
product requirments document -
кью эй - тестировщик
эмиты 
дебакеры
